107
8
12 4 0 0 4 4 4 4 0 0 0 0 4 4 8 4 8 4 4 4 6 4 4 8 0 0 0 0 0 0 0 0 0 0 0 0 0 0 0 0 0 0 0 8 4 8 4 4 4 4 4 4 4 4 4 4 4 4 4 4 4 4 4 4 4 4 4 4 4 4 4 4 4 4 4 4 4 4 4 4 0 0 0 4 4 4 4 4 0 0 0 0 0 0 0 0 0 0 0 4 4 4 0 0 0 4 4 
12 0 0 0 0 0 0 0 0 0 0 0 0 0 4 6 4 4 8 6 6 4 4 4 4 8 4 4 4 8 4 4 4 0 0 0 0 0 0 0 0 0 0 0 0 0 0 0 0 0 0 0 0 0 0 0 0 0 0 0 0 0 0 0 0 0 0 0 0 0 0 0 0 0 0 4 4 4 4 4 4 4 4 4 4 4 4 4 4 4 4 4 4 4 4 4 4 4 4 4 4 4 4 4 4 0 4
12 0 0 0 0 0 0 0 0 0 0 0 0 0 0 6 8 4 6 0 0 0 0 0 0 0 4 8 4 4 4 4 4 0 0 0 0 0 0 0 0 0 0 4 0 0 0 0 0 4 0 0 0 0 0 0 0 0 0 0 0 0 0 0 0 0 0 0 0 0 0 4 0 0 0 0 4 4 4 4 4 4 4 4 4 4 4 4 4 0 0 4 4 4 4 4 4 4 0 0 4 4 4 4 4 0 0 
12 0 0 0 0 6 0 0 0 0 0 0 0 6 6 6 8 4 0 0 0 0 0 0 0 0 0 0 0 0 0 0 0 0 4 8 4 8 4 8 0 0 0 0 0 0 0 4 4 4 4 0 0 0 0 0 0 0 0 0 0 0 0 0 4 0 0 0 0 0 0 0 0 0 0 0 0 0 0 0 0 0 0 4 0 0 0 0 4 4 4 0 0 0 0 0 0 0 4 4 4 4 4 0 4 0 0 
12 0 0 0 0 1 2 3 4 5 6 7 8 9 10 11 12 13 14 15 16 17 18 19 20 21 22 23 24 25 4 0 0 0 0 8 4 8 0 0 0 0 0 0 4 4 4 4 4 0 0 0 0 0 0 0 4 4 4 4 0 0 0 4 0 0 0 0 0 0 4 4 4 4 4 0 0 0 0 0 0 0 0 0 0 4 0 0 0 0 0 4 4 0 0 0 0 0 0 4 4 4 4 4 0 8 4 4 4 4 0 4 4 4 4 4 4 4 4 4 4
12 0 0 0 0 0 0 0 0 4 4 8 0 0 8 4 4 0 0 0 0 0 0 0 6 8 6 6 0 0 0 0 0 0 0 4 4 4 4 0 0 0 0 0 0 0 0 4 4 4 4 4 4 4 0 0 0 0 0 4 4 0 0 0 0 0 0 4 0 0 0 0 0 0 4 0 0 0 0 0 4 4 4 4 4 4 0 0 0 4 0 0 0 0 4 0 0 0 4 4 4 4 4 0 0 0 0 
12 0 0 8 6 6 8 4 8 8 4 0 0 0 4 6 4 6 6 4 0 0 4 8 6 8 6 0 4 4 4 4 4 0 0 0 0 4 4 4 4 4 4 4 0 4 4 4 0 0 4 4 4 4 4 4 4 4 4 4 0 0 0 0 0 0 0 4 0 0 4 4 0 0 4 0 0 4 4 4 4 4 0 0 0 0 0 0 0 0 0 0 0 4 4 0 0 4 0 4 4 4 4 4 4 4 4
12 4 4 4 4 4 4 4 8 4 4 4 8 8 8 4 4 0 0 0 0 0 4 8 4 6 6 4 4 4 8 4 8 4 4 4 4 6 4 6 6 4 6 4 6 4 4 4 4 4 4 4 4 4 4 4 4 4 4 4 4 4 4 4 4 4 4 4 4 4 4 4 0 0 0 0 4 4 4 4 4 4 0 4 4 4 0 0 0 0 0 0 0 0 4 4 0 0 0 0 0 0 0 0 4 4 4 